##############
#11H#  ####  #
#1####  ##  #
#223#  ##  #
### # ##  #
#        #
#########